#########
#       #
# . . $@#
# $     #
#       #
#########
